NO ./saleunin.png
SO ./saleunin.png
EA ./wall.png

WE ./wall.png

F 220,100,0
C 225,30,0


111111111111111111111111111111111                              
100010001000000000110000000000001
100001001011000001110000000000011
100000101001000000000000000000001
1111011110110000011100000000000011
100000000011000001110111111111111
11110111111111011100000010001
11110111111111011101010010001
11000000110101011100000010001
10000000000000001100000W10001
10000000000000001101010010001
110000011101010111110111100111
11110111 1110101 101111010001
11111111 1111111 111111111111
11111111111111111111111111111
 
11111
