NO ./rups.png
SO ./path_to_the_south_texture
EA ./path_to_the_east_texture




WE ./path_to_the_west_texture

F 220,100,0
C 225,30,0

11111111111111111111111111111111111111111111111111111
10000000000000000000000000000000000000000000000000001
1000000000000000000000011N011000000000000000000000001
10000000000000000011111001100111110000000000000000001
10000000000000001100000001100000001100000000000000001
10000000000000010000000001100000000010000000000000001
10000000000011100000000001100000000001110000000000001
10000000001100000000000000000000000000001100000000001
10000000010000000000000000000000000000000001000000001
10000000100000000000000000000000000000000000100000001
10000000100000000000000000000000000000000000100000001
10000000010000000000000000000000000000000001000000001
10000000010000000000000000000000000000000001000000001
10000000001000000000000000000000000000000010000000001
10000000000100000000000000000000000000000100000000001
10000000000010000000000000000000000000001000000000001
10000000000001000000000000000000000000010000000000001
10000000000001000000000000000000000000010000000000001
10000000000001000000000000000000000000010000000000001
10000000000001000000000000000000000000010000000000001
10000000000001000000000000000000000000010000000000001
10000000000001000000000000000000000000010000000000001
10000000000001000000000000000000000000010000000000001
10000000000001000000000000000000000000010000000000001
10000000000001000000000000000000000000010000000000001
10000000000001000000000000000000000000010000000000001
10000000000001000000000000000000000000010000000000001
10000000000001000000000000000000000000010000000000001
10000000000001000000000000000000000000010000000000001
10000000000001000000000000000000000000010000000000001
10000000000001000000000000000000000000010000000000001
10000000000001000000000000000000000000010000000000001
10000000000011000000000000000000000000011000000000001
10000000000100000000000000000000000000000100000000001
10000000011000000000000000000000000000000011000000001
10000001100000000000000000000000000000000000110000001
10000001000000000000000001111000000000000000010000001
10000000100000000000000010000010000000000000001000001
10000000010000000000000010000010000000000000010000001
10000000001000000000000100000001000000000000100000001
10000000000111000000011000000000110000000111000000001
10000000000000111111100000000000000111111000000000001
10000000000000000000000000000000000000000000000000001
11111111111111111111111111111111111111111111111111111